111
 101111111111
 111000001111
 111111111111