11111
101001
1010001
10100001
101000001
10100001
1010001
1010010
11111
