NO lol
WE ./assets/wall.xpm


EA ./assets/wall.xpm
SO       ./assets/wall.xpm


C 0,444,1111111





111111111111
1000000N0011111111111
11111111111
