111
111111111111
100000000001
 1111111111
     1111