1111111111111111111
1111111111111111111
1100000000000000011
1101001010010000011
1101001001010101011
110100101N010000011
1101000001010101011
1111111111111111111
1111111111111111111