 11111   
 1000011    
 1110001111 
   111N0011
    1100011 
    1111111 
             