1111111111111111111
1111111111111111111
11E0000000000000011
1101001010010000011
1101001001010101011
1101001010010000011
1101000001010101011
1111111111111111111
1111111111111111111