NO ./assets/wall.xpm
WE ./assets/wall.xpm


EA ./assets/wall.xpm
SO       ./assets/wall.xpm








 111111111111
1N00000  0011111111111
 1111111111111