11111111111111111
10000000000000001
10100101001000001
10100100101010101
10100101E01000001
10100000101010101
11111111111111111
