NO ./textures/wood.xpm
WE ./textures/pillar.xpm


EA ./textures/purplestone.xpm
SO       ./textures/bluestone.xpm

C 1,1,1
F           1,1,2





111111111111
1000000N0011111111111
11111111111
