NO lol
WE ./assets/wall.xpm


EA ./assets/wall.xpm
SO       ./assets/wall.xpm

C 1,1,1
F 1,1,





111111111111
1000000N0011111111111
11111111111
