1111111111111111111111111111111111
1111111111111111111111111111111111
11000000000000000S0000000000000011
1100000000000000000000000000000011
1100000000000000000000000000000011
1100000000000000000000000000000011
1100000000000000000000000000000011
1100000000000000000000000000000011
1100000000000000000000000000000011
1100000000000000000000000000000011
1100000000000000000000000000000011
1100000000000000000000000000000011
1100000000000000000000000000000011
1100000000000000000000000000000011
1100000000000000000000000000000011
1111111111111111111111111111111111
1111111111111111111111111111111111