1111111111111111111
1111111111111111111
11S0000000000100011
1101001010010000011
1101001001010101011
1101001010010000011
1101001001010101011
1111111111111111111
1111111111111111111