1111111111111111111
1111111111111111111
11000000000S0000011
1101001010010000011
1101001001010101011
1101001010010000011
1101000001010101011
1111111111111111111
1111111111111111111