11111111111111111
1S000000000010001
10100101001000001
10100100101010101
10100101001000001
10100100101010101
11111111111111111
