1111111111111111111111111111111111
1N00000000000000000000000000000101
1010010100100000101001000000010101
1010010010101010001001000000010101
1010010100100000101001000000010101
1010010010101010001001000000010101
1010010100100000100001000000010101
1010010010101010000001000000010101
1010010100100000000001000000010101
1010010010101010001001000100010101
1010010100100000101001000000010101
1010010010101010001001000000010101
1010010100100000101001000000010101
1010010010101010001001001000010101
1010010100100000101001000000010101
1010010010101010001001000000101001
1000000000000000000000000000000001
1111111111111111111111111111111111
