 11111   
 1000011    
 1110001111 
   11100011 
    1100011 
    1111111 
             