







SO	./textures/colorstone.xpm                            				









WE          ./textures/mossy.xpm 




EA	./textures/colorstone.xpm

NO ./textures/mossy.xpm  
C 			0,0,0    




F 0,0,0



111111
1001
 1N11111111111111
1101
111
1  1 1 1 1 1 1 1
1     1      1




111
101
111
1
1
1
1






































































































































































