SO ./textures/colorstone.xpm
NO ./textures/bluestone.xpm
EA                                 ./textures/mossy.xpm                
WE ./textures/eagle.xpm
C 255,0,0
F                   0,0,0
1111111111111111
100000000S000001
1000000000000001
1000000000000001
1111111111111111
1000000000000001
1000000000000001
1111111111111111
1
1
1
1
1
1
1
1
1
