NO ./textures/bluestone.xpm
SO ./textures/colorstone.xpm
WE ./textures/eagle.xpm
EA ./textures/mossy.xpm
F 220,100,0
C 225,30,0
1111111111111111
1000000000000001
100000000N000001
1000000000000001
1111111111111111
