SO ./textures/colorstone.xpm
EA                                 ./textures/mossy.xpm                
C 0,0,0
F                   0,0,0
1111111111111111
100000000S000001
1000000001000001
1000000010000001
1000000001000001
1000000010000001
1000000000000001
1111111111111111
1
1
1
1
1
1
1
1
1
